17 20
XXXXXXXXXXXXXXXOXXXX
OOOXXXXXXXXXXXXOXXXX
XXOXXXXXXXXXXXXOXXXX
XXOXXOOOXXXXXXXOXXXX
XXOXXOXOXXXXXXXOOOXX
XXOXXOXOXXXXXXXOXXXX
XXOOOOXOXXXXXXXOXXXX
XXXXXXXOXXXXXXXOXXXX
XXXXXXXOXXOOOOOOXXXX
XXXXXXXOXXOXXOXXXXXX
XXXXOOOOXXOXXOXXXXXX
XOOOOXXXXXOXXOXXXXXX
XXXXOXXXXXOXXOXXXXXX
XXXXOXXXXXOOXXXXXXXX
XXXXOXXXXXOXXXXXXXXX
XXXXOOOOOOOXXXXXXXXX
XXXXXXXXXXXXXXXXXXXX	

