10 10
XXXXXXXXXX
OOXOOOOOOX
XOXOXOXXOX
XOXOXXXXOX
XOXOOOOXOX
XOXOXXXXOX
XOXOOOOXOX
XOXXXXOXOX
XOOOOOOXOO
XXXXXXXXXX
